R 1920 1080
NO     ./xpm_file/wall_1.xpm
SO ./xpm_file/wall_2.xpm
WE ./xpm_file/wall_3.xpm
EA ./xpm_file/wall_4.xpm
S ./xpm_file/sprite_1.xpm
F ./xpm_file/floor_1.xpm
C 1,11,220

11111111111111111111111111
1000000000110000000000001
1011000001110000002000001
1001000000000000000000001
111111111011000001111111111111
100000000011000001110111111111111
11110111111111011100000010001
11110111111111011101010010001
11000000110101011100000010001
10002000000000001100000010001
10000000000000001101010010001
11000001110101011111011110N0111
11110111 1110101 101111010001
11111111 1111111 111111111111
